Title: Ah bis Zett
----
Date: 2004-06-02
----
Category: Fun, Gesellschaft
----
Summary: 
----
Tags: 
----
Image: 
----
Text:
K – Kids: Noch keine…  
L – Longest car ride ever: Ich brauch nie sehr lang…  
M – Mom’s name: Rosi (=Rosemarie, sagt aber niemand…)  
N – Number of people you slept with: Rede ich nur mit »E« drüber ;)  
O – Obsession\[s\]: Internet, Computer, Mittermeier  
P – Phobia\[s\]: Schule…  
Q – Quote: »Leute, ihr seid unruhig!«  
R – Reason to smile: Im Moment eher wenige… aber es wird :)  
S – Song you sang last: Keine Ahnung…  
T – Time you wake up: Viertel nach 6. Manchmal auch 6 Stunden später…  
U – Unknown fact about me: Ich hab ein Muttermal…  
V – Vegetable you hate: Spargel…  
W – Worst habit: Internet, Computer, Schule  
X – X-rays you’ve had: Zähne, Fuß (links)... ansonsten, keine Ahnung  
Y – Yummy food: Kohlrouladen  
Z – Zodiac sign: Schütze

via: [Dirk Steins](http://www.dirksteins.de/)